swwwwwwwwwwwwcwwwws
s.................s
s.................s
s......tttttttt...s
s......tmmmmmmt...s
s......t......t...s
s.............TTTTs
s.................s
s.................s
s.................s
s.................s
s.........p.f..c..s
sssssssssssssssssss
