swwwwwwwwwwwwcwwwws
s.................s
s.................s
s......tttttttt...s
s......t......t...s
s......t......t...s
s.............TTTTs
s...........f.....s
s.................s
s.................s
s.................s
s.........p.......s
sssssssssssssssssss
